čovek	čovjek
čoveka	čovjeka
čovekov	čovjekov
čovekove	čovjekove
BELA	BIJELA
Bela	Bijela
Cena	Cijena 
Cenu	Cijenu
DELIMIČNO	DJELIMIČNO
DEO	DIO
Dela	Djela
Delatnost	Djelatnost
Delimična	Djelimična
Delimični	Djelimični
Delimično	Djelimično
Delokrug	Djelokrug
Delovi	Dijelovi
Delu	Djelu
Deo	Dio
Deobe	Diobe
Deobi	Diobi
Deobom	Diobom
Dodele	Dodjele
Izmena	Izmjena
Izmenama	Izmjenama
Izmene	Izmjene
Izveštaj	Izvještaj
Izveštaji	Izvještaji
Izveštavanje	Izvještavanje
LEKU	LIJEKU
Lek	Lijek
Leku	Lijeku
Maloletna	Maloljetna
Mere	Mjere
Mesto	Mjesto
Namera	Namjera
Obaveštava	Obavještava
Obaveštavanje	Obavještavanje
Obaveštenja	Obavještenja
Obeležavanje	Obilježavanje
Obezbeđenja	Obezbjeđenja
Ocenjivanja	Ocjenjivanja
Ocenom	Ocjenom
Odeljak	Odjeljak
Odeljenja	Odjeljenja
Odsek	Odsjek
Odseka	Odsjeka
Ovde	Ovdje
Oštinskog	Opštinskog
POSEDA	POSJEDA
POVERAVAJU	POVJERAVAJU
POVERLjIVO	POVJERLjIVO
PREDLOG	PRIJEDLOG
PREDSEDNIK	PREDSJEDNIK
Posed	Posjed
Posledice	Posljedice
Poverenik	Povjerenik
Poverenika	Povjerenika
Povereniku	Povjereniku
Poverilac	Povjerilac
Poveriočeva	Povjeriočeva
Poverljiva	Povjerljiva
Poverljive	Povjerljive
Poverljivih	Povjerljivih
Poverljivom	Povjerljivom
Poverljivu	Povjerljivu
Predlog	Prijedlog
Predloga	Prijedloga
Predsednica	Predsjednica
Predsednik	Predsjednik
Predsednika	Predsjednika
Premeru	Premjeru
Primena	Primjena
Primenjuje	Primjenjuje
Procenjena	Procijenjena
Promena	Promjena
REŠENjE	RJEŠENjE
Razmenu	Razmjenu
Razrešava	Razrješava
Reč	Riječ
Rešavajući	Rješavajući
Rešavanje	Rješavanje
Rešenja	Rješenja
Rešenje	Rješenje
Rešenjem	Rješenjem
Samoprocena	Samoprocjena
Samoprocenu	Samoprocjenu
Savestan	Savjestan
Sedište	Sjedište
Sledom	Slijedom
Sledstveno	Sljedstveno
Udela	Udjela
Udeo	Udio
Umesto	Umjesto
Usled	Usljed
Uverenje	Uvjerenje
Verovala	Vjerovala
Veća-Sudija	Vijeća-Sudija
Veštak	Vještak
Veštačenjem	Vještačenjem
Vrednost	Vrijednost
Vrednosti	Vrijednosti
Vreme	Vrijeme
Zahtev	Zahtjev
Zastarelosti	Zastarjelosti
beleg	biljeg
belega	biljega
belegama	biljegama
beleženje	bilježenje
bezbedan	bezbjedan
bezbedno	bezbjedno
bezbednosni	bezbjednosni
bezbednost	bezbjednost
bezbednostan	bezbjednostan
bezbednosti	bezbjednosti
bezbednu	bezbjednu
cel	cijel
cela	cijela
cele	cijele
celi	cijeli
celina	cjelina
celine	cjeline
celini	cjelini
celinu	cjelinu
celishodnost	cjelishodnost
celog	cijelog
celoj	cijeloj
celokupan	cjelokupan
celokupne	cjelokupne
celokupno	cjelokupno
celokupnog	cjelokupnog
celokupnom	cjelokupnom
celom	cijelom
celost	cijelost
celosti	cijelosti
celovit	cjelovit
celovitost	cjelovitost
celu	cijelu
cena	cijena
cenama	cijenama
cene	cijene
ceneći	cijeneći
ceni	cijeni
cenio	cijenio
ceniti	cijeniti
cenom	cijenom
cenovan	cjenovan
cenovne	cjenovne
cenovnika	cjenovnika
cenu	cijenu
ceo	cio
cvetan	cvjetan
cvetnih	cvjetnih
deca	djeca
decac	djecac
dece	djece
deci	djeci
decom	djecom
decu	djecu
deda	djed
del	djel
dela	djela
delatnost	djelatnost
delatnosti	djelatnosti
delatnošcu	djelatnošcu
delijski	dijeljinski
delimičan	djelimičan
delimične	djelimične
delimičnim	djelimičnim
delimično	djelimično
delimičnu	djelimičnu
delo	djelo
delokrug	djelokrug
delokruga	djelokruga
delokrugu	djelokrugu
delom	djelom
delova	dijelova
delovanja	djelovanja
delovanje	djelovanje
delovanjima	djelovanjima
delovati	djelovati
delove	dijelove
delovi	dijelovi
delovima	dijelovima
delu	djelu
deluje	djeluje
deo	dio
deoba	dioba
deobe	diobe
deobi	diobi
deobom	diobom
deobu	diobu
dete	dijete
detet	djetet
deteta	djeteta
detete	djetete
detetom	djetetom
devojci	djevojci
devojka	djevojka
devojke	djevojke
devojkom	djevojkom
dodel	dodjel
dodela	dodjela
dodeli	dodjeli
dodeliti	dodijeliti
dodeljen	dodijeljen
dodeljena	dodijeljena
dodeljene	dodijeljene
dodeljivanja	dodjeljivanja
dodeljivanje	dodjeljivanje
dodeljivanjem	dodjeljivanjem
dodeljivati	dodjeljivati
dole	dolje
donela	donijela
donelo	donijelo
doneo	donio
donet	donesen
doneta	donesena
donete	donesene
doneti	doneseni
donetih	donesenih
donetim	donesenim
doneto	doneseno
donetog	donesenog
donetoj	donesenoj
donetom	donesenom
donešen	donesen
donešenu	donesenu
dosledno	dosljedno
dospele	dospjele
dospeli	dospjeli
dospelih	dospjelih
dospelost	dospjelost
dospelosti	dospjelosti
dospeo	dospio
dospeti	dospjeti
dve	dvije
dvestasedam	dvjestasedam
dvosed	dvosjed
gde	gdje
grejanja	grijanja
grejanje	grijanje
htela	htjela
htele	htjele
hteo	htio
hteti	htjeti
istovetan	istovjetan
istovetna	istovjetna
istovetnih	istovjetnih
izbegavala	izbjegavala
izbegavati	izbjegavati
izbegne	izbjegne
izbegnuti	izbjegnuti
izbeći	izbjeći
izmena	izmjena
izmenama	izmjenama
izmene	izmjene
izmeni	izmjeni
izmenile	izmijenile
izmenili	izmijenili
izmenio	izmijenio
izmeniti	izmijeniti
izmenjen	izmijenjen
izmenjena	izmijenjena
izmenjenom	izmijenjenom
izmenu	izmjenu
iznele	iznijele
izneli	iznijeli
izneo	iznio
iznet	iznijet
izneti	iznijeti
iznetih	iznijetih
iznetim	iznijetim
iznetog	iznijetog
izvesno	izvjesno
izvesnoj	izvjesnoj
izvesnu	izvjesnu
izvestan	izvjestan
izvestiti	izvijestiti
izveštaj	izvještaj
izveštaja	izvještaja
izveštaje	izvještaje
izveštajem	izvještajem
izveštaji	izvještaji
izveštajima	izvještajima
izveštaju	izvještaju
izveštavanja	izvještavanja
izveštavanje	izvještavanje
izveštavati	izvještavati
lek	lijek
lekarske	ljekarske
lekarski	ljekarski
lekarsku	ljekarsku
leku	lijeku
levo	lijevo
maloletan	maloljetan
maloletna	maloljetna
maloletne	maloljetne
maloletnik	maloljetnik
maloletnika	maloljetnika
maloletno	maloljetno
maloletnog	maloljetnog
maloletnu	maloljetnu
menica	mjenica
menice	mjenice
menicu	mjenicu
menični	mjenični
meničnim	mjeničnim
menja	mijenja
menjanje	mijenjanje
menjati	mijenjati
mera	mjera
merama	mjerama
mere	mjere
meri	mjeri
merodavan	mjerodavan
merodavna	mjerodavna
merodavnim	mjerodavnim
merodavno	mjerodavno
meru	mjeru
mesan	mjesan
mesec	mjesec
meseca	mjeseca
mesece	mjesece
meseci	mjeseci
mesecima	mjesecima
mesecu	mjesecu
mesečan	mjesečan
mesečna	mjesečna
mesečne	mjesečne
mesečni	mjesečni
mesečnih	mjesečnih
mesečno	mjesečno
mesečnog	mjesečnog
mesni	mjesni
mesnih	mjesnih
mesta	mjesta
mestan	mjestan
mestima	mjestima
mesto	mjesto
mestom	mjestom
mestu	mjestu
međuvreme	međuvrijeme
meša	miješa
mešanje	miješanje
mešati	miješati
najpre	najprije
namena	namjena
namene	namjene
nameni	namjeni
nameniti	namijeniti
namenjen	namijenjen
namenjena	namijenjena
namenjene	namijenjene
namenjeni	namijenjeni
namenom	namjenom
namenski	namjenski
namenu	namjenu
namera	namjera
namerama	namjerama
nameran	namjeran
namerava	namjerava
nameravan	namjeravan
nameravanim	namjeravanim
nameravati	namjeravati
namere	namjere
nameri	namjeri
namerno	namjerno
namernog	namjernog
namerom	namjerom
nameru	namjeru
namestiti	namjestiti
nameštaj	namještaj
namešten	namješten
naneti	nanijeti
napred	naprijed
nasledan	nasljedan
naslednik	nasljednik
naslednika	nasljednika
naslednike	nasljednike
naslednička	nasljednička
nasledničke	nasljedničke
naslednički	nasljednički
nasledničku	nasljedničku
naslednog	nasljednog
nasleđa	nasljeđa
nasleđe	nasljeđe
nasleđivanja	nasljeđivanja
nasleđivanje	nasljeđivanje
nasleđivanjem	nasljeđivanjem
nasleđivanju	nasljeđivanju
nedelja	nedjelja
nedeljan	nedjeljan
nedelje	nedjelje
nedeljni	nedjeljni
nedoslednost	nedosljednost
nega	njega
negde	negdje
nege	njege
negu	njegu
nemačke	njemačke
nemačkih	njemačkih
neprimenjiv	neprimjenjiv
neprimenjivo	neprimjenjivo
nesavesne	nesavjesne
nesavestan	nesavjestan
nesrazmera	nesrazmjera
nesrazmeri	nesrazmjeri
nesvesno	nesvjesno
neverovatan	nevjerovatan
neverovatna	nevjerovatna
nevreme	nevrijeme
obavesti	obavijesti
obavestio	obavijestio
obavestiti	obavijestiti
obaveštava	obavještava
obaveštavaju	obavještavaju
obaveštavajući	obavještavajući
obaveštavanja	obavještavanja
obaveštavanje	obavještavanje
obaveštavati	obavještavati
obavešten	obaviješten
obaveštena	obaviještena
obaveštenja	obavještenja
obaveštenje	obavještenje
obaveštenjem	obavještenjem
obaveštenjima	obavještenjima
obaveštenju	obavještenju
obe	obje
obeju	obiju
obeležavanje	obilježavanje
obeleže	obilježe
obeležiti	obilježiti
obeležja	obilježja
obeležje	obilježje
obelodaniti	objelodaniti
obelodanjeni	objelodanjeni
obema	objema
obezbede	obezbijede
obezbedi	obezbijedi
obezbedila	obezbijedila
obezbedilo	obezbijedilo
obezbedio	obezbijedio
obezbediti	obezbijediti
obezbeđen	obezbijeđen
obezbeđena	obezbijeđena
obezbeđenih	obezbijeđenih
obezbeđenja	obezbjeđenja
obezbeđenje	obezbjeđenje
obezbeđivanja	obezbjeđivanja
obezbeđivanje	obezbjeđivanje
obezbeđivati	obezbjeđivati
obezbeđuje	obezbjeđuje
obezbeđuju	obezbjeđuju
obezvrediti	obezvrijediti
obezvređen	obezvrijeđen
oboleo	obolio
ocena	ocjena
ocene	ocjene
oceni	ocjeni
ocenio	ocijenio
oceniti	ocijeniti
ocenjivanja	ocjenjivanja
ocenjivanje	ocjenjivanje
ocenjivanjem	ocjenjivanjem
ocenjivati	ocjenjivati
ocenjuje	ocjenjuje
ocenu	ocjenu
odeljak	odjeljak
odeljenja	odjeljenja
odeljenje	odjeljenje
odeljenju	odjeljenju
odeljkom	odjeljkom
odeća	odjeća
odeće	odjeće
odeću	odjeću
odmerena	odmjerena
odmereno	odmjereno
odmeriti	odmjeriti
odsek	odsjek
opredelila	opredijelila
opredelio	opredijelio
opredeliti	opredijeliti
oseti	osjeti
osetiti	osjetiti
ovde	ovdje
overa	ovjera
overava	ovjerava
overavaju	ovjeravaju
overavati	ovjeravati
overe	ovjere
overen	ovjeren
overeni	ovjereni
overenim	ovjerenim
overeno	ovjereno
overenog	ovjerenog
overenom	ovjerenom
overenu	ovjerenu
overi	ovjeri
overili	ovjerili
overiti	ovjeriti
overu	ovjeru
podela	podjela
podele	podjele
podeli	podjeli
podeliti	podijeliti
podeljen	podijeljen
podeljeni	podijeljeni
podeljeno	podijeljeno
podeljenog	podijeljenog
podelom	podjelom
podlegati	podlijegati
podleže	podliježe
podnela	podnijela
podneli	podnijeli
podnelo	podnijelo
podneo	podnio
podnet	podnesen
podneta	podnesena
podnete	podnesene
podneti	podneseni
podnetih	podnesenih
podnetim	podnesenim
podnetog	podnesenog
podnetu	podnesenu
podrazumeva	podrazumijeva
podrazumevaju	podrazumijevaju
podrazumevale	podrazumijevale
podrazumevalo	podrazumijevalo
podrazumevati	podrazumijevati
posed	posjed
poseda	posjeda
posedovali	posjedovali
posedovao	posjedovao
posedovati	posjedovati
posedu	posjedu
poseduje	posjeduje
poseduju	posjeduju
poseta	posjeta
posle	poslije
posledica	posljedica
posledicama	posljedicama
posledice	posljedice
posledicu	posljedicu
poslednja	posljednja
poslednje	posljednje
poslednjeg	posljednjeg
poslednjem	posljednjem
poslednji	posljednji
poslednjih	posljednjih
potkrepiti	potkrijepiti
potkrepljen	potkrijepljen
poverava	povjerava
poveravati	povjeravati
povere	povjere
poveren	povjeren
poverena	povjerena
poverene	povjerene
poverenik	povjerenik
poverenika	povjerenika
poverenja	povjerenja
poverenje	povjerenje
povereno	povjereno
poverenog	povjerenog
poverilac	povjerilac
poverilaca	povjerilaca
poverilačka	povjerilačka
poverilački	povjerilački
poverilca	povjerilca
poverioca	povjerioca
poveriocama	povjeriocima
poverioci	povjerioci
poveriocima	povjeriocima
poveriocu	povjeriocu
poveriočev	povjeriočev
poveriočeve	povjeriočeve
poveriočevog	povjeriočevog
poveriti	povjeriti
poverljiv	povjerljiv
poverljiva	povjerljiva
poverljive	povjerljive
poverljivih	povjerljivih
poverljivim	povjerljivim
poverljivost	povjerljivost
poverljivosti	povjerljivosti
poverovalo	povjerovalo
poverovati	povjerovati
povlači	povlači
povodom	povodom
povreda	povreda
povrede	povrede
povredila	povrijedila
povrediti	povrijediti
povredu	povredu
povređen	povrijeđen
povređena	povrijeđena
povređenih	povrijeđenih
povređeno	povrijeđeno
povređenog	povrijeđenog
pre	prije
predlog	prijedlog
predloga	prijedloga
predloge	prijedloge
predlogom	prijedlogom
predlogu	prijedlogu
predlozi	prijedlozi
predlozima	prijedlozima
predsedava	predsjedava
predsedavajući	predsjedavajući
predsedavati	predsjedavati
predsednica	predsjednica
predsednik	predsjednik
predsednika	predsjednika
predsedniku	predsjedniku
predupredila	preduprijedila
preduprediti	preduprijediti
predvideti	predvidjeti
prek	prijek
premer	premjer
premera	premjera
premeru	premjeru
premeštaj	premještaj
preneo	prenio
preneta	prenesena
preneti	prenijeti
preraspodela	preraspodjela
preraspodeli	preraspodjeli
presedatelj	presjedatelj
presek	presjek
preseke	presjeke
preselenja	preseljenje
preselenje	preseljenja
pretnja	prijetnja
pretnje	prijetnje
pretnjom	prijetnjom
pretrpe	pretrpio
pretrpe	pretrpjeti
pretrpela	pretrpjela
pretrpeo	pretrpio
pretrpeti	pretrpjeti
primedba	primjedba
primedbama	primjedbama
primedbe	primjedbe
primedbi	primjedbi
primena	primjena
primene	primjene
primeni	primjeni
primenili	primjenili
primenio	primjenio
primeniti	primijeniti
primeniti	primjeniti
primeniće	primijeniće
primeniće	primjeniće
primenjen	primijenjen
primenjenim	primijenjenim
primenjiv	primjenjiv
primenjivan	primjenjivan
primenjivanih	primjenjivanih
primenjivati	primjenjivati
primenjivaće	primjenjivaće
primenjivih	primjenjivih
primenjivom	primjenjivom
primenjuje	primjenjuje
primenjuju	primjenjuju
primenjujući	primjenjujući
primenom	primjenom
primenu	primjenu
primer	primjer
primerak	primjerak
primeraka	primjeraka
primerci	primjerci
primercima	primjercima
primeren	primjeren
primereni	primjereni
primerenom	primjerenom
primerka	primjerka
primetila	primijetila
primetiti	primijetiti
prispele	prispjele
prispeo	prispio
prispeća	prispijeća
prispeće	prispijeće
procena	procjena
procenama	procjenama
procene	procjene
proceni	procjeni
procenila	procijenila
proceniti	procijeniti
procenjen	procijenjen
procenjena	procijenjena
procenjene	procijenjene
procenjenom	procijenjenom
procenjivanja	procjenjivanja
procenjivanje	procjenjivanje
procenjivati	procjenjivati
procenjuju	procjenjuju
procenu	procjenu
promena	promjena
promenama	promjenama
promene	promjene
promeni	promjeni
promenila	promijenila
promenio	promijenio
promeniti	promijeniti
promenjen	promijenjen
promenjene	promijenjene
promenjenih	promijenjenih
promenom	promjenom
promenu	promjenu
prosek	prosjek
proseku	prosjeku
prosečan	prosječan
prosečna	prosječna
prosečne	prosječne
prosečnim	prosječnim
prosečnog	prosječnog
prosveta	prosvjeta
prosvetan	prosvjetan
prosvete	prosvjete
prosvetni	prosvjetni
protivrednost	protivrijednost
protivrednosti	protivrijednosti
protivrečan	protivrječan
protivrečnom	protivrječnom
protivrečnost	protivrječnost
protivvrednost	protivvrijednost
protivvrednosti	protivvrijednosti
provera	provjera
proverava	provjerava
proveravati	provjeravati
provere	provjere
proveriti	provjeriti
proveru	provjeru
punoletan	punoljetan
punoletne	punoljetne
punoletno	punoljetno
raspodela	raspodjela
raspodeli	raspodjeli
raspodeljivati	raspodjeljivati
raspodeljuje	raspodjeljuje
rasveta	rasvjeta
rasvete	rasvjete
razmena	razmjena
razmeni	razmjeni
razmenjivati	razmjenjivati
razmenjuju	razmjenjuju
razmenu	razmjenu
razmera	razmjera
razrešava	razrješava
razrešavati	razrješavati
razrešenja	razrješenja
razrešenje	razrješenje
razrešenju	razrješenju
razrešiti	razriješiti
razume	razumije
razumeti	razumjeti
razumevanje	razumijevanje
redosled	redosljed
redosledu	redosljedu
reč	riječ
reči	riječi
rešava	rješava
rešavaju	rješavaju
rešavajući	rješavajući
rešavanja	rješavanja
rešavanje	rješavanje
rešavanju	rješavanju
rešavati	rješavati
rešavaće	rješavaće
reše	riješe
rešene	riješene
rešeni	riješeni
rešenja	rješenja
rešenje	rješenje
rešenjem	rješenjem
rešenju	rješenju
reši	riješi
rešio	riješio
rešiti	riješiti
savesnim	savjesnim
savesnog	savjesnog
savesnost	savjesnost
savesnosti	savjesnosti
savestan	savjestan
savet	savjet
saveta	savjeta
savetnicima	savjetnicima
savetnik	savjetnik
savetnika	savjetnika
savetnikom	savjetnikom
sedenje	sjedenje
sedišta	sjedišta
sedište	sjedište
sedištem	sjedištem
sedištem	sjedštem
sedištu	sjedištu
sednica	sjednica
sednicama	sjednicama
sednice	sjednice
sednici	sjednici
sednicu	sjednicu
sećanja	sjećanja
sećanje	sjećanje
sledbenik	sljedbenik
sledbenika	sljedbenika
sledbeniku	sljedbeniku
sledeća	sljedeća
sledeće	sljedeće
sledećeg	sljedećeg
sledećem	sljedećem
sledeći	sljedeći
sledećih	sljedećih
sledećim	sljedećim
sledećoj	sljedećoj
sledeću	sljedeću
sledi	slijedi
slediti	slijediti
sledstveno	sljedstveno
sme	smije
smeju	smiju
smena	smjena
smenama	smjenama
smene	smjene
smestio	smjestio
smestiti	smjestiti
smeti	smjeti
smeštaj	smještaj
smeštaja	smještaja
smeštena	smještena
snabdeju	snabdiju
snabdeti	snabdjeti
snabdeven	snabdjeven
snabdevenu	snabdjevenu
sporazumeju	sporazumiju
sporazumele	sporazumjele
sporazumeli	sporazumjeli
sporazumeti	sporazumjeti
sprečen	spriječen
sprečeno	spriječeno
sprečenost	spriječenost
sprečenosti	spriječenosti
spreči	spriječi
sprečila	spriječila
sprečili	spriječili
sprečilo	spriječilo
sprečio	spriječio
sprečiti	spriječiti
srazmera	srazmjera
srazmeran	srazmjeran
srazmeri	srazmjeri
srazmerno	srazmjerno
streljan	strijeljan
streljanje	strijeljanje
streljanjem	strijeljanjem
streljati	strijeljati
susedan	susjedan
susednih	susjednih
susetka	susjetka
svedoci	svjedoci
svedok	svjedok
svedoka	svjedoka
svedoke	svjedoke
svedokinja	svjedokinja
svedokinje	svjedokinje
svesna	svjesna
svesni	svjesni
svesno	svjesno
svest	svijest
svestan	svjestan
svetske	svjetske
svetski	svjetski
tela	tijela
telo	tijelo
tko	ko
tromesečje	tromjesječje
tromesečju	tromjesječju
trosed	trosjed
trpeti	trpjeti
udel	udio
udela	udjela
udeli	udjeli
udelom	udjelom
udelu	udjelu
udeo	udio
umesto	umjesto
umetnički	umjetnički
umetničkim	umjetničkim
umetničkog	umjetničkog
umeša	umiješa
umešati	umiješati
umišljaj	umišljaj
unapred	unaprijed
uneo	unio
unet	unesen
uneta	unesena
unete	unesene
uneti		uneseni
uneti	uneseni
unetih	unesenih
unetim	unesenim
uneto	uneseno
unetoh	unesenih
unetom	unesenom
unetu	unesenu
upotrebiti	upotrijebiti
upotrebljeni	upotrijebljeni
usled	usljed
usledio	uslijedio
uslediti	uslijediti
uspe	uspije
uspeh	uspjeh
uspehu	uspjehu
uspeti	uspjeti
uspešan	uspješan
uspešno	uspješno
uvek	uvijek
uveravaju	uvjeravaju
uveravati	uvjeravati
uverenja	uvjerenja
uverenje	uvjerenje
uverenjem	uvjerenjem
uverljivost	uvjerljivost
uvrediti	uvrijediti
venčan	vjenčan
venčanih	vjenčanih
venčanja	vjenčanja
venčanje	vjenčanje
vera	vjera
veri	vjeri
verodostojan	vjerodostojan
verodostojne	vjerodostojne
verovatan	vjerovatan
verovati	vjerovati
verovatnim	vjerovatnim
verovatno	vjerovatno
verski	vjerski
versko	vjersko
verskom	vjerskom
veru	vjeru
veća-sudija	vijeća-sudija
veća-sudije	vijeća-sudije
veštak	vještak
veštaka	vještaka
veštačenja	vještačenja
veštačenje	vještačenje
veštačenjem	vještačenjem
veština	vještina
veštinama	vještinama
videli	vidjeli
videlo	vidjelo
video	vidio
videti	vidjeti
vredeti	vrijediti
vredi	vrijedi
vrediti	vrijediti
vrednost	vrijednost
vrednosti	vrijednosti
vreme	vrijeme
zabeležena	zabilježena
zabeležene	zabilježene
zabeležiti	zabilježiti
zahtev	zahtjev
zahteva	zahtjeva
zahtevai	zahtjevai
zahtevaju	zahtijevaju
zahtevajući	zahtijevajući
zahtevala	zahtijevala
zahtevalo	zahtijevalo
zahtevan	zahtjevan
zahtevane	zahtjevane
zahtevani	zahtjevani
zahtevano	zahtijevano
zahtevanom	zahtjevanom
zahtevao	zahtijevao
zahtevati	zahtijevati
zahteve	zahtjeve
zahtevi	zahtjevi
zahtevima	zahtjevima
zahtevna	zahtjevna
zahtevoa	zahtijevao
zahtevom	zahtjevom
zahtevoti	zahtijevati
zahtevu	zahtjevu
zamena	zamjena
zamene	zamjene
zamenik	zamjenik
zamenike	zamjenike
zamenio	zamijenio
zameniti	zamijeniti
zameniće	zamijeniće
zamenjivati	zamjenjivati
zamenjuje	zamjenjuje
zamenom	zamjenom
zamenu	zamjenu
zaposedne	zaposjedne
zaposesti	zaposjesti
zapretiti	zaprijetiti
zastarelost	zastarjelost
zastarelosti	zastarjelosti
zastarelošću	zastarjelošću
zastareva	zastarijeva
zastarevaju	zastarijevaju
zastarevanja	zastarijevanja
zastarevanje	zastarijevanje
zastarevati	zastarijevati
želela	željela
želeti	željeti
živeli	živjeli
živelo	živjelo
živeo	živio
živeti	živjeti
